Artist	Song Title	NA
3 Doors Down	"When I'm Gone"	Yes
Ashlee Simpson	"Boyfriend"	Yes
Avril Lavigne	"My Happy Ending"	Yes
Boys Like Girls	"The Great Escape"	Yes
Cartel	"Lose It"	Yes
Colbie Caillat	"Bubbly"	Yes
Dixie Chicks	"Not Ready to Make Nice"	Yes
Duran Duran	"Ordinary World"	Yes
Evanescence	"Bring Me To Life"	Yes
Fall Out Boy	"Thnks fr th Mmrs"	Yes
Fergie	"Big Girls Don't Cry"	Yes
Gwen Stefani feat. Akon	"The Sweet Escape"	Yes
The Hives	"Tick Tick Boom"	Yes
Jennifer Lopez	"Jenny From the Block"	Yes
Lifehouse	"First Time"	Yes
Lily Allen	"Littlest Things"	Yes
Lloyd	"Get it Shawty"	Yes
Maroon 5	"Makes Me Wonder"	Yes
Matchbox Twenty	"How Far We've Come"	Yes
Michelle Branch	"Breathe"	Yes
Nelly Furtado	"Promiscuous"	Yes
Norah Jones	"Don't Know Why"	Yes
The Outfield	"Your Love"	Yes
Peter Bjorn and John	"Young Folks"	Yes
P!nk	"Who Knew"	Yes
Plain White T's	"Hey There Delilah"	Yes
Rihanna	"Umbrella"	Yes
Santana feat. Chad Kroeger	"Into The Night"	Yes
Steriogram	"Walkie Talkie Man"	Yes
Sum 41	"Fat Lip"	Yes
